    #####
    #   #
    #   #
  ###   ##
  #      #
### # ## #   ######
#   # ## #####  ..#
#              $..#
##### ### #@##  ..#
    #     #########
    #######
